m.0w4gsdr The Power and the Glory	William K. Howard
m.0c1nkhz Surfacing	Margaret Atwood
m.08lbqz_ For Better, for Worse	Cecil B. DeMille
m.08lbrjq The Cricket	Stefano Lorenzi
m.0swhrw1 The Winning Strain	Leslie Winik
m.07k59fy Mighty Mouse in Gypsy Life	Rasinski
m.0pdgw78 A Common Purpose	Mitzi Goldman
m.0c1g41j Teeth of the Wind	Charlotte Boyett-Compo
m.064s_s2 Curvy Girls	Rachel Kramer Bussel
m.08lbqgs The Boy Kumasenu	Sean Graham
m.0gkrcz4 My Grandpa	Alison Reynolds	
m.0gksdx2 The 8th Day	Kayden Kross
m.0gkrm3g In The Doghouse	James Burrows With Dan Butler	
m.0gkrm3g In The Doghouse	Carly Simon
m.0nbv_9z Two Thirds Sky: Artists in Desert Country	Sean O
m.0g50wl8 Un dios que ya no ampara	Gaizka Urresti Gui√≥n
m.0nc5vq2 Wings as Eagles	Benjamin Harlan Publisher
m.0jvrp The House in the Middle	Kelly Chisholm
m.0w4gnpd The River Nile	Rachael Ramsey
m.0gksjmg Glass Tears	Barbara Wong
